ascii 15 14
...............
..***********..
...............
....R.....R....
.....R...R.....
....RRRRRRR....
...RR.RRR.RR...
..RRRRRRRRRRR..
..R.RRRRRRR.R..
..R.R.....R.R..
.....RR.RR.....
...............
..***********..
...............
