ascii 15 13
...............
....******.....
..****.*****...
.*****.******..
....*********..
.......*******.
.........*****.
.......*******.
....*********..
.************..
..**********...
....******.....
...............
